I                                                                 WWWWWWWWWWWWWW
I                                                                 WWWWWWWWWWWWWW
I                                                                 WWWWWWWWWWWWWW
I DD                                                              WWWWWWWWWWWWWW
I DD                                                              WWWWWWWWWWWWWW
BBBBB                                                             WWWWWWWWWWWWWW
0000     BBBBBBBSSSSBBBSSSSBB                                     WWWWWWWWWWWWWW
0000                              B                               WWWWWWWWWWWWWW
0000                                  B                           WWWWWWWWWWWWWW
0000                                                              WWWWWWWWWWWWWW
0000                                                              WWWWWWWWWWWWWW
0000                        B     B        B                      WWWWWWWWWWWWWW
0000                    B   0     0        0                      WWWWWWWWWWWWWW
0000                    0   0     0        0                      WWWWWWWWWWWWWW
0000                 B  0   0     0        0                      eWWWWWWWWWWWWW
0000  H M       DDDDD0  0   0     0        0              M       EWWWWWWWWWWWWW
0000BBBBBBBBBBBBBBBBB0SS0SSS0SSSSS0SSSSSSSS0SSSSBBBBBBBBBBBBBBBBBB00000000000000
00000000000000000000000000000000000000000000000000000000000000000000000000000000
00000000000000000000000000000000000000000000000000000000000000000000000000000000
00000000000000000000000000000000000000000000000000000000000000000000000000000000
00000000000000000000000000000000000000000000000000000000000000000000000000000000
00000000000000000000000000000000000000000000000000000000000000000000000000000000
00000000000000000000000000000000000000000000000000000000000000000000000000000000
00000000000000000000000000000000000000000000000000000000000000000000000000000000
00000000000000000000000000000000000000000000000000000000000000000000000000000000
00000000000000000000000000000000000000000000000000000000000000000000000000000000
00000000000000000000000000000000000000000000000000000000000000000000000000000000