I                         W
I                         W
I                         W
IBBBB   B  B   B          W
I                  B      W
I                         W
I                        DW
I                        DW
I                        DW
B         BB    B    B   BW
I       B                 W
I                         W
I    BB   SSSSSSSSSSSSS   W
IB                        W
I                         W
I             DDDDD        
BBBBBBBBBBBBBBBSSSBBBBBBBBW