I                                                                 WWWWWWWWWWw
I                                                                 WWWWWWWWWWw
I                                                                 WWWWWWWWWWw
I DD                                                              WWWWWWWWWWw
I D                                                               WWWWWWWWWWw
IBBBB                                                             WWWWWWWWWWw
I        BBBBBBBSSSSBSSSSSSBB                                     WWWWWWWWWWw
I                                 B                               WWWWWWWWWWw
I                B                    B                           WWWWWWWWWWw
I             B                                                   WWWWWWWWWWw
I                                                                 WWWWWWWWWWw
I                           B     B        B                      WWWWWWWWWWw
I                       B                                         WWWWWWWWWWw
I                                                                 WWWWWWWWWWw
I                    B                                            WWWWWWWWWWw
I             DDDDD        
BBBBBBBBBBBBBBBBBBBBBSSSSSSSSSSSSSSSSSSSSSSSSSSSBBBBBBBBBBBBBBBBBBBBBBBBBBBBB
00000000000000000000000000000000000000000000000000000000000000000000000000000
00000000000000000000000000000000000000000000000000000000000000000000000000000
00000000000000000000000000000000000000000000000000000000000000000000000000000
00000000000000000000000000000000000000000000000000000000000000000000000000000